mmmmmmmmmmmmmmmmmmmmmmmmmmmmmmmm
m                              m
m                              m
m                              m
m                              m
m                              m
m                              m
m                              m
m                              m
m                 m            m
m            e    m            m
m        mmmmmmmmmm            m
m    m                         m
m    m                         m
m    mmm                       m
m          mm   mm             m
m         m       m            m
m        m         m           m
m       m           m          m
m      m             m         m
m     m      m  m     m        m
m    m       m  m      m       m
m   m        m  m       m      m
mmmmmmmmmmmmmmmmmmmmmmmmmmmmmmmm